000000000000000
210000001111110
010111110111110
010111110111110
010110010111110
010001111100010
011110111111110
011110110000010
010100111111113
011111101010110
010000111111110
011011111001110
011010000111110
011001111111110
000000000000000