000000000000000
211111111111110
011111111111110
011111111111110
011111111111110
011111111111110
011111111111110
011111111111110
011111111111113
011111111111110
011111111111110
011111111111110
011111111111110
011111111111110
000000000000000